EA ./textures/EA.xpm
NO ./textures/NO.xpm
SO ./textures/SO.xpm
WE ./textures/WE.xpm
C 135,206,235
F 116,102,59



1111111111111111111111111111111111111111111111111111
1000000000000000000000000000000000000000000000111101
1000000000000000000000000000000000000000000000000001
1000000000000000000000000000001111111100000000000001
100000000000000000000000000001        10000000000001
1000000000000000000000000000001111111100000000000001
1000000000000001100001110000111000111000000000000001
1000000000000000100000010000001000001000000000000001
1000000000000000100001110000111000001000000000000001
1000000000000000100000010000001000001000000000000001
1000000000000001110001110000111000001000000000000001
1000000000000000000000000000000000000000000000000011
10000000000000000000N0000000000000000000000000000001
1000000000000000000000000000000000000000000000000001
1000000000000000000000000000000000000000000000000001
1000000000000000000000000000000000000000000000000001
1111111111111111111111111111111111111111111111111111