EA ./maps/test_map.cub
NO ./maps/test_map.cub
SO ./maps/test_map.cub
WE ./maps/test_map.cub
C 225,30,0
F 220,100,0




1111111111111111111111111111111111111111111111111111
1000000000000000000000000000000000000000000000000001
1000000000000000000000000000000000000000000000000001
1000000000000000000000000000000000000000000000000001
1000000000000000000000000000000000000000000000000001
1000000000000000000000000000000000000000000000000001
1000000000000001000000111110001110011111000000000001
1000000000000011000001000010010010000001000000000001
1000000000000101000000000010010010000001000000000001
1000000000001001000000111110000110000111110000000001
1000000000000001000000000010000010000001000000000001
1000000000000111110000111110001110000001000000000001
1000000000000000000000000000000000000000000000000001
1000000000000000000000000000000000000000000000000001
1000000000000000000000000000000000000000000000000001
1000000000000000000000000000000000000000000000000001
1000000000000000000000000000000000000000000000000001
1000000000000000000000000000000000000000000000000001
1000000000000000000000000000000000000000000000000001
1000000000000000000000000000000000000000000000000001
10000000000000000000000S0000000000000000000000000001
1000000000000000000000000000000000000000000000000001
1000000000000000000000000000000000000000000000000001
1000000000000000000000000000000000000000000000000001
1111111111111111111111111111111111111111111111111111