EA ./textures/EA.xpm
NO ./textures/NO.xpm
SO ./textures/SO.xpm
WE ./textures/WE.xpm
C 225,30,0
F 220,100,0




1111111111111111111111111111111111111111111111111111
1000000000000001000000000000000000000000000000000001
1000000000000001000000000000000000000000000000000001
1000000000000001000000000000000000000000000000000001
1000000000000001000000000000000000000000000000000001
1000000000000001000000000000000000000000000000000001
1000000000000001000000000000000000000000000000000001
1000000000000001100001110000111000111000000000000001
1000000000000000100000010000001000001000000000000001
1000000000000000100001110000111000001000000000000001
1000000000000000100000010000001000001000000000000001
1000000001111111110001110000111000001000000000000001
10000000100000000000N0000000000000000000000000000001
1111111110000000000000000000000000000000000000000001
1000000000000000000000000000000000000000000000000001
1000000000000000000000000000000000000000000000000001
1111111111111111111111111111111111111111111111111111