EA ./textures/EA.xpm
NO ./textures/NO.xpm
SO ./textures/SO.xpm
WE ./textures/WE.xpm
C 255,255,0                  
F 0,0,0

1111111111111111111111111111111111111111111111111111
1000000000000000000000000000000000000000000000000001
1000000000000000000000000000000000000000000000000001
1000000000000000000000000000000000000000000000000001
1000000000000000000000000000000000000000000000000001
1000000000000000000000000000000000000000000000000001
1000000000000000000000000000000000000000000000000001
1000000000000001100001110000111000111000000000000001
1000000000000000100000010000001000001000000000000001
1000000000000000100001110000111000001000000000000001
1000000000000000100000010000001000001000000000000001
1000000001111100110001110000111000001000000000000001
10000000100000000000N0000000000000000000000000000001
1111111110000000000000000000000000000000000000000001
1000000000000000000000000000000000000000000000000001
1000000000000000000000000000000000000000000000000001
1111111111111111111111111111111111111111111111111111