EA ./maps/test_map.cub
NO ./maps/test_map.cub
SO ./maps/test_map.cub
WE ./maps/test_map.cub
C 225,30,0
F 220,100,0




1111111111111111111111111
1000000000110000000000001
1011000001110000000000001
10010000000000000000000011
11111111101100000111000000111111
100000000011000001110111010011111
11110111111111011100000010001
11110111111111011101010010001
1100000S11011101110000001000111
1000000000001 100001100000010001
1000000000001100110101001000111111111
1100000111010101111101111000111111011
11110011 11101010101111010001    1101
11111111 1111111111111111111      101
                                   11